XXXXXXXXXXXXXXXXXXXXXXXXXXXXXXX
XE__________X_______X_________X
X_XXXXX_XXX_X_XXXXX_X_XXX_XXX_X
X_____X_____X_____X_____X_____X
XXXX_XX_XXXXXXXXX_XXXXX_XXXXX_X
X_o_____o___X_______o_______o_X
X_X_XXXXX_X_XXXXXXXXX_XXX_XXX_X
X___X___X___X_____X_____X_____X
XXX_X_o_X_XXX_X_X_XXXXX_X_XXXXX
X_______X_____X_X_____X_X_____X
X_XXXXXXX_XXXXX_XXX_XXX_XXX_X_X
X_____o_______o_____X_____o___X
X_XXXXX_XXXXXXXXX_XXX_XXXXX_XXX
X_____X_____X_______X_____X___X
X_XXX_XXX_X_XXX_XXXXX_XXX_XXX_X
X_o___X___X_____X_____X___o___X
XXX_XXXXX_XXXXX_X_XXX_XXXX__XXX
X___X_____X_____X_X_____X_____X
X_X_XXX_XXX_XXX_X_XXX_XXX_XXX_X
X_o___X___o___X___o___X___o__SX
XXXXXXXXXXXXXXXXXXXXXXXXXXXXXXX
